###############################
#    P  #                #    S
#       #       #        #    #
#  ######       #        #    #
#               #             #
#               #             #
###############################